210 40 4 6 3
250 40 1 2 5 4
290 40 1 2 4

190 75 2 5 6
230 75 1 2 3 4 5 6
270 75 1 2 3 4 5 6
310 75 2 5 6

170 110 2 5 6
210 110 1 2 3 5
250 110 1 2 3 5
290 110 1 2 3 5
330 110 1 2 3

150 145 1 2 3 5
190 145 1 2 3 4 5 6
230 145 1 2 3 4 5 6
270 145 1 2 3 4 5 6
310 145 1 2 3 4 5 6
350 145 1 2 3 5

130 180 1 2 3 5
170 180 1 2 3 4 5 6
210 180 1 2 3 4 5 6
250 180 1 2 3 4 5 6
290 180 1 2 3 4 5 6
330 180 1 2 3 4 5 6
370 180 1 2 3 5

110 215 1 2 3 5
150 215 1 2 3 4 5 6
190 215 1 2 3 4 5 6
230 215 1 2 3 4 5 6
270 215 1 2 3 4 5 6
310 215 1 2 3 4 5 6
350 215 1 2 3 4 5 6
390 215 1 2 3 5

90 250 1 6 3
130 250 1 2 3 4 5 6
170 250 1 2 3 4 5 6
210 250 1 2 3 6
250 250 2
290 250 1 2 3 4 5 6
330 250 1 2 3 4 5 6
370 250 1 2 3 4 5 6
410 250 1 2 3

110 285 1 2 3 5
150 285 1 2 3 4 5 6
190 285 1 2 3 4 5 6
230 285 1 2 3 4 5 6
270 285 1 2 3 4 5 6
310 285 1 2 3 4 5 6
350 285 1 2 3 4 5 6
390 285 1 2 3 5

130 320 1 2 3 5
170 320 1 2 3 4 5 6
210 320 1 2 3 4 5 6
250 320 1 2 3 4 5 6
290 320 1 2 3 4 5 6
330 320 1 2 3 4 5 6
370 320 1 2 3 5

150 355 1 2 3 5
190 355 1 2 3 5 6
230 355 1 2 3 5 6
270 355 1 2 3 5 6
310 355 1 2 3 5 6
350 355 1 2 3 5

170 390 1 6 5
210 390 1 2 3 5
250 390 1 2 3 5
290 390 1 2 3 5
330 390 1 2 3

190 425 2 5 6 3
230 425 1 2 5 6
270 425 1 2 5 6
310 425 2 5 6

210 460 1 2 3
250 460 1 2 5 4
290 460 1 2 4
